88888888
88818888
88808888
88840418
81042888
88884888
88881888
88888888
