88888888
88800088
81240088
88804188
81884088
80801088
84054418
80001008
88888888
